DCCMMCMCMMMMOMM
MMCMCCMMCMMMCCC
MCCMCMCCCMMMMMC
MCMMCCCMMMCCCCC
CCMMMMMPMMMCMMM
CMMMCCCCMMMMMMM
CCCCCMMMMMMMCCM
MMCMMMQMMCMCMCM
CCCMMMCCMMMMCCM
CCMMMCMCCCMMCMC
MCCCCCMMMCMMMMM
MMMMMCCCCCMCMMM
MMMMCCMMMMMCMMM
MCMMCMMMCCCCMMM
MCMMSMMMCMMMCMM