DCCMMCMEMMMMCMM
MMCMCCMMCMMMCCC
MXCCCMCCCMMMMMC
MCMMCCCMMMCCCCC
CCMMMMMCMMMCMMM
CMMMCCCCMCCCMMM
CCCCCMMCCCMMEEM
MMCMMMCMMCMEMEM
CCCMMMCCMMMMEEM
CCMMMCMCCCMMEME
MCCCCCMMMCMMMMM
MMMMMCCCCCMEMMM
MMMMCCMMMMMEMMM
MEMMCMMMEEEEMMM
MEMMSMMMEMMMEMM
