DCCMMCMCMMMMOMM
MMCMCCMMCMMMCCC
MCCCCMCCCMMMMMC
MOMMCCCMMMCCCCC
CCMMMMMPMMMCMMM
CMMMCCCCMCCCMMM
CPCCCMMCCCMMCCM
MMCMMMQMMCMCMCM
CCCMMMCCMMMMCCM
CCMMMCMCCCMMCMC
MCCCCCMMMCMMMMM
MMMMMCCCCCMCMMM
MMMMCCMMMMMCMMM
MCMMCMMMCCCCMMM
MCMMSMMMCMMMCMM