DCOMMCMCMMMMOMM
MMCMCCMMCMMMCCC
MCOCCMCCCMMMMMC
MOMMCCCMMMCCCCC
CCMMMMMPMMMCMMM
CMMMCCCCMCCCMMM
CCCCCMMCCCMMCCM
MMCMMMQMMCMCMCM
CCCMMMCCMMMMCCM
CCMMMCMCCCMMCMC
MCCCCCMMMCMMMMM
MMMMMCCCCCMCMMM
MMMMCCMMMMMCMMM
MCMMCMMMCCCCMMM
MCMMSMMMCMMMCMM