DCCMMCMEMMMMOMM
MMCMCCMMCMMMCCC
MCCCCMCCCMMMMMC
MCMMCCCMMMCCCCC
CCMMMMMPMMMCMMM
CMMMCCCCMCCCMMM
CCCCCMMCCCMMEEM
MMCMMMQMMCMEMEM
CCCMMMCCMMMMEEM
CCMMMCMCCCMMEME
MCCCCCMMMCMMMMM
MMMMMCCCCCMEMMM
MMMMCCMMMMMEMMM
MEMMCMMMEEEEMMM
MEMMSMMMEMMMEMM