DCCMMCMCMMMMOMM
MMCMCCMMCMMMCCC
MCCCCMCCCMMMMMC
MCMMCCCMMMCCCCC
CCMMMMMPMMMCMMM
CMMMCCCCMCCCMMM
CCCCCMMCCCMMCCM
MMCMMMQMMCMCMCM
CCCMMMCCMMMMCCM
CCMMMCMCCCMMCMC
MCCCCCMMMCMMMMM
MMMMMCCCCCMCMMM
MMMMCCMMMMMCMMM
MCMMCMMMCCCCMMM
MCMMSMMMCMMMCMM